solid - фундаментальний
imperative to have - обов'язково мати
robust - міцний\надійний
appreciate - оцінять
comparative analysis - порівняльний аналіз
advantages - переваги


siblings - брати і сестри
immediate - негайний

niece - племінниця
nephew - племінник

in-laws - (сім'я партнера)
spouse - дружина
mother-in-law
father-in-law
brother-in-law
sister-in-law
daughter-in-law
son-in-law

granddaughter - внучка
grandson   - внук
great-aunt - пра-тітка
great-uncle - пра-дядько
great-niece 
great-nephew
greatgrandmother
great-grandfather
great-great-grandfather
great-great-grandmother

step-mother - мачуха
step-father - вітчим
step-sisters - зведена сестра
step-brothers - зведений брат
half-brothers - звыдны брати
half-sisters - звыдны сестри
foster-parents (foster-mother/fosterfather)
foster-child (foster-son/foster-daughter)
blood relative - кровний родич
nuclear family - 
single-parent - єдиний батько
one-parent family - неповна сім'я
kin              - родич
extended family - розширена родина
close-knit family - дружна сім'я
dysfunctional family



acquaintance - знайомий
colleague - колега
workmate - товариш по службі
adore - обожнюю
to loathe - ненавидіти
to worship - поклонятися
to idolize - поклонятися
can’t stand - не витримую
to admire - захоплюватися
to look up to - дивитися на
to admire - захоплюватися
to look down on - дивитися з висоти
to despise - зневажати
to attract - щоб залучити
to turn smb. on - перетворювати smb на
to repel (formal) - відштовхуватися (формально)
to turn smb. off (informal) - перетворювати smb вимкнено (неофіційно)
to be attracted to - приваблювати
to fancy - фантазувати




Core - центр, глибинна сутність; 
caveman - печерна людина; 
however - однак, незважаючи на…; 
diversified - різноманітний, багатосторонній; 
essential - суттєвий; 
reach out - звертатися до…, тримати зв'язок з...;
to treat - ставитися до…;
resourcefulness - винахідливість, кмітливість; 
scriptural - біблійний; 
bond - зв'язок; 
deed - вчинок; 
customary - звичайний;
to deepen - поглиблювати; 
to institute - засновувати, встановлювати; 
generosity - великодушність, щедрість;
appreciation - оцінка, визнання; 
to promote - підтримувати, стимулювати; 
partly - частково; 
to sustain - підтримувати,сприяти; 
span - тривалість життя; 
to thrive - процвітати; 
folk(s) - (розм.) родичі, рідня.
